########################
#............#.........#
#.A..........#.........#
#####........#.........#
#...#........###D#######
#...#..K...............#
#...#.....##############
#...#.....#............#
########################