##########
#A...#...#
#....D...#
#....#...#
#....#####
#.K......#
##########