########################
#A.........#...........#
#..........#...........#
#..####....#....####...#
#..#..#....#....#..#...#
#..#..#.........#K.#...#
#..#..######.####..#...#
#..#.............D.#...#
########################